決心をする	に	事に
昼寝をする	で	上で
迫害を加える	から	昔から
家族をする	を	が	愛を	我等猫族が
投書をする	て	へ	やって	ほととぎすへ
話をする	て	と	かたまって	云いますと
失笑を禁じる	は	吾輩は
欠伸をする	と	が	挟むのと	主人が
報道をする	に	耳に
御馳走を食う	と	見ると
雑談をする	は	ながら	黒は	寝転びながら
自慢を繰り返す	に	新しそうに
呼吸を飲み込む	から	なってから
思案を定める	まで	ここまで
御馳走をあるく	て	って	なって	猟って
放蕩をする	も	云うよりも
写生を力む	に従って	忠告に従って
写生をする	から	しから
対話を聞く	で	椽側で
半分をする	と	は	相違ないなと	主人は
苦心をする	から	さっきから
勉強をする	と	て	たり	見ると	行列して	開いたり
存在を認める	まで	から	今まで	世間から
談話を聞く	は	吾輩は
合奏をやる	も	と	一昨夜も	ちょいと
往来を通る	と	見ると
返事をする	と	いいだろうと
間食をする	で	忍んで
我儘をする	が	他人が
慰安を求める	に	遺書に
喧嘩をする	と	叔父さんと
按摩を愛す	も	安井息軒も
治療をうける	も	は	豪傑でも	時々は
位置をする	ば	とか	揉まなければ	癒らぬとか
是非を食う	は	君は
挨拶をする	から	いいから
晩酌を始める	て	から	見えて	今夜から
遠征をする	に	まで	黒のように	肴屋まで
始末をつける	で	あるだけで
適をする	は	に	動物は	直覚的に
降参をする	から	と	は	しようがないから	出来ませんと	手際では
合図をする	と	て	聞いたかと	して
形容をなさる	に	見て来たように
同情を表する	に	文章言辞に
研究を続ける	て	て	組織しまして	会合して
心中をやる	は	せんだっては
同情を持つ	に	人物に
質問をする	と	は	に	訳だろうと	独仙君は	独仙君だけに
尽力を仰ぐ	も	ので	で	先生にも	やるつもりなので	ためで
捺印を願う	へ	これへ
御馳走を致す	に	東風子に
著述を居る	て	より	依て	此間中より
嘔吐を信じる	と	うちと
厚遇を受ける	まで	が	かくまで	猫が
含嗽をやる	で	毎朝風呂場で
講釈をする	わ	か	存じませんわ	御存じないですか
苦心を買う	と	が	が	読むと	僕が	人が
是非を願う	から	も	やるつもりだから	先生にも
復讐をとる	と	は	に	大違いだと	主人は	一度に
経験をする	ば	に	は	いえば	暮に	僕は
息をつく	と	は	聞かし玉えと	主人は
在宿を願う	から	伺いたいから
真似をする	は	男は
ストライキを起す	て	が	に	なって	活気が	一度に
談判をする	と	が	いでしょうと	知らないが
見物をする	って	教師だからって
註釈を加える	と	が	急病だねと	迷亭が
苦労をする	たり	聞かなかったり
相談をする	から	は	寝てしまったから	ものはまた
約束をする	に	それに博士夫人に
覚悟をする	と	駄目だと
化粧をする	に	そのかたのように
妨害をする	と	が	つけると	ゲーが
早死をする	は	よしは
いたずらをする	て	思って
身震いをする	は	て	吾輩は	にたてて
回向を受ける	は	が	から	今頃は	御師匠さん自身が	月桂寺さんから
虐待をする	て	知らずして
同情を寄せる	から	人間から
接待を命ずる	も	計らずも
供を可愛がる	て	に	てって	——たまに
説教をやる	と	は	で	さあと	迷亭は	調子で
同情を表す	と	は	に	ものだからねと	東風君は	大に
返答をする	と	は	て	が	分りませんねと	細君は	立てて	促が
弁護をする	と	あんなですよと
定義をする	て	開き直って
沈黙を守る	も	くらい	人間も	猫くらい
演説をする	けども	て	先生じゃないけども	招待して
批評を願う	から	は	で	拝見したから	今度は	読んで
絞殺を用いる	として	処刑として
絞殺をする	から	今から
失策を及ぶ	に	御報道に
調和を計る	から	西洋人だから
敬意を表する	に	鼻に
話を伺う	て	出まして
噂を致す	は	と	で	牧山様には	なると	宿で
心配を願う	も	へ	つきましても	牧山さまへ
談判を聞く	で	蔭で
研究をやる	て	は	しているのでございます	大学院では
質問をえる	で	これで
失礼を致す	は	て	は	鼻子は	見えて	これは
要求をする	と	願いますと
著述をする	が	は	で	知るまいが	人は	九十四歳で
噂をする	が	に	これが	君に
睡眠を縮める	に	四時間に
訪問を受ける	も	図らずも
談話をする	が	吾輩が
撰をする	て	から	が	云って	自から	男であるが
許諾を至る	て	を	経ずして	吾妻橋事件などを
報道を逢う	て	として	忍ばして	得々として
決心を起す	と	出掛けようと
自覚を与る	に	彼等に
意味を示す	と	は	分っているよと	神さんは
息を凝らす	て	切って
未遂をせしめる	て	して
電話を切る	と	馬鹿にすると
番を染め出す	て	ので	へ	いらっしゃいまして	御求め遊ばしたので——	鶯茶へ
電話を出る	は	と	令嬢は	はいと
批評を加える	と	が	なかなか振っていますなと	寒月君が
清聴を煩わす	から	て	ございますから	披瀝して
真似をやる	は	と	て	迷亭は	思いますと	立ち上って
注意をする	て	と	被って	云うと
刺激を与える	て	に	続いたりして	耳底に
発達を致す	が	て	は	応ずるが	比例して	時は
抗議を申し込む	と	が	大袈裟だねと	主人が
復讐をやる	と	は	よしていただきましょうと	寒月君は
出入を貰う	は	を	て	は	て	人間は	ものを	吐呑して	以上は	して
所有をする	で	切り刻んで
遠慮をする	に	ものに
想像をする	ながら	ついでながら
談話を承る	て	行って
下宿をする	が	に	私が	いっしょに
出所をする	に	不分明に
依頼をする	と	は	訳でありますからと	御客さんは
同宿をする	は	から	と	君は	学生時代から	苦沙弥と
是非を動かす	ば	見ようとすれば
観察を始める	から	辺から
大発見をなす	に	辺に
試験をする	に	国に
喧嘩を譲る	に	後日に
随行を命ずる	へ	所へ
質問をかける	と	は	結婚したんだと	主人は
情死をする	と	金と
変化を来す	に	表面に
説明を与える	と	は	て	事じゃあないかと	鈴木君は	つけて
吶喊を喰う	と	まごまごしているとまた
問答をやる	で	禅家で
外出をする	でも	僕あいつでも
写生を引き裂く	から	で	思ったから	手で
西洋を奢る	て	でも	受けて	何でも
賭をする	から	思ったから
契約をすます	と	逼ると
説法を受ける	て	逢って
研究をする	について	鼻についてまた
依頼をうける	で	極楽主義で
心理を有する	へ	ところへ
講義をする	で	一室で
休養を欲する	は	状態は
倹約をする	と	あくまいと
観察を積む	が	人間自身が
変化を求める	て	消耗して
製造を負う	で	一手で
左右を見る	に	一時に
変化をあらわす	に	上に
変化を生じる	に	と	発音に	自然と
変化を生ずる	の	を	に	今日のごとく	顔を	目まぐるしきまでに
議論をする	て	来て
発展をする	まで	ここまで
休養を要する	は	に	と	吾輩は	前に	一と
対談をする	が	と	て	に	主人夫婦が	巡査と	晴れ渡って	勝手口に
告訴をする	から	今から
国をする	と	が	うまかあと	三平君が
自炊をする	が	で	僕等が	御寺で
休養を得る	は	に	者は	ために
休養を乞う	は	て	に	は	吾輩は	ありて	ために	汝は
自弁をやる	すら	は	に	木強漢ですら	時々は	日曜以外に
座禅をする	で	で	飛び込んで	上で
修行をする	から	昔しから
故障を挟む	に	猫鍋に
脱線をする	が	に	云うがごとく	電鉄に
辞職をする	が	に	要求するがごとく	主人に
戦争をする	は	でも	主人は	これでも
安心を得る	で	修養で
安心を欲する	も	吾輩も
答弁を得る	に対して	問題に対して
代理を勤める	に	通しに
暴行をする	に	が	一枚向うに	敵が
舞踏をいる	は	で	に	鼠は	中で	盛に
区劃を立てる	と	で	へ	しないと	三分の割合で	上へ
観察を怠る	て	取られて
仕事をする	し	は	やるし	なってからは
反応を呈す	と	も	か	来ると	皮膚も	幾分か
辞儀をする	は	て	に	て	主人は	向いて	鄭寧に	見えて
御馳走を来る	で	今途中で
懸念をする	と	さえ	大丈夫かいと	主人さえ
問答をする	について	の	隠れ家について	かくのごとく
息を入れる	て	で	使って	中途で
研究を要する	が	で	安心させてやりたいのですが	問題で
註釈をつける	と	の	是非入れたいよと	例のごとく
談話を分る	まで	今まで
息をする	は	から	と	と	主人は	鼻から	フンと	冗談じゃないと
工夫をする	から	ぷうぷう吹くから
失恋をする	て	向って
一段落を告げる	が	それが
結婚を申し込む	に	御夏さんに
返事を聞く	で	申し込んで
返事を待つ	て	平らげて
小便をする	て	は	なって	図書館へは
弁難をする	て	赤くなって
合奏をする	に	と	寒月君のように	人と
観察を述べる	で	が	声で	一つして見せたが
托をやる	なんて	よしかなんて
体操をする	が	に	女学生が	一心不乱に
講義を行く	て	て	に	て	豁然大悟して	きて	ききに	聞いて
落着を告げる	は	で	刑事事件は	これで
不足を云う	で	これで
行水を出す	へ	下へ
行水を見下ろす	と	と	て	見ると	見ると	とまって
講釈をいる	が	伺が
質問を受ける	すら	本人ですら
送籍を打つ	と	が	と	に	云うと	迷亭が	馬鹿だよと	単簡に
芝居をする	で	独逸で
交際をする	から	て	は	招待してから	なって	それからは
運動を始める	は	吾輩は
病気をする	から	それだから
薨去を落ちる	て	云って
呼吸を引き取る	って	も	に	往復したって	一匹も	上に
広告を出す	ば	飛込めば
抵抗を生ずる	で	が	に対して	法則で	機能が	狂瀾怒濤に対して
変化を起こす	て	に	叩いて	上に
往来をあるく	は	て	今では	さげて
一大を試みる	が	坊ばが
小便をかける	に	から	最後に	蝉から
御馳走をする	にて	常磐にて
猶予を与える	に	彼等に
反応をする	も	記号も
摩擦を行う	か	で	こすり付けるか	皮で
松をやる	によって	方法によって
影響を与える	に	男に
困却をする	て	を	が	なって	当局者を	職員が
由来を案ずる	て	退いて
競争をやる	ば	で	出来なければ	化物なりで
差別を立てる	は	も	赤裸は	どこまでも
談笑をする	も	て	て	と	に	は	羽織も	上げて	露出して	平然と	縦まに	一団体は
忠告を加える	と	に	あぶないよと	熱心に
同情を求める	と	に	ながら	湧いてくると	化物に	寄せながら
代理を務める	は	これは
あいだをする	に	中に
鑑定をつける	は	と	に	は	これは	相違ないと	際に	吾輩は
喧嘩を始める	は	を	彼は	生意気書生を
怒号をする	ばかり	結果とばかり
不便をする	が	て	軍隊が	あって
通行をする	は	て	ハンニバルは	しておいて
逆戻りをする	に	世界に
速断をやる	に	と	鳴くに	極っていると
道楽をする	て	して
旅行をする	て	して
道楽をすすめる	に	ものに
御馳走を食わせる	から	て	に	してやるから	大事にして	晩に
北面を取り囲む	に	は	て	として	名前に	税は	屈曲して	事として
教育をくる	で	学校で
喧嘩を見る	と	見ると
了見を抱く	と	見たいと
深入りをする	は	正面までは
遊弋をする	て	で	から	入れて	所で	いるから
使用を思う	も	は	光栄とも	吾輩は
診断をする	も	から	あれも	医学上から
逆上をする	は	て	と	プレートーは	持って	狂気と
逆上を重んずる	で	中で
発達を立てる	か	幾分か
間接を行う	も	から	戦争にも	海軍から
威嚇を出す	に	と	度に	合せてわーと
居眠りをする	て	控えて
行動をする	が	敵が
戦闘をする	んで	予想せんで
午睡をする	て	出て
是非を話す	は	として	あとには	順序として
防禦を講じる	に対して	敵に対して
講話をする	は	て	主人は	傾けて
訓戒を与える	に	かように
講話を聞く	が	に	主人が	真面目に
遊戯をくだける	に	日本人に
逆上をがる	て	号して
戦争をなす	に	下に
供給を仰ぐ	も	戦争でも
戦争を挑む	に	に	必竟ずるに	主人に
講義をきく	から	うちから
供をつる	が	主人が
学問をする	て	入れて
逆上を振る	に	大に
訓戒を加える	に	ないように
容赦を願う	が	は	出来ますが	これは
供をする	に	相手に
後悔をする	けれど	号するのだけれど
報知を致す	に	帰りがけに
診察を受ける	て	迎えて
診察を始める	と	一つ拝見しましょうかと
自殺をする	に	なかに
満足を求める	は	て	文明は	変化させて
関係をする	に	欧洲人のように
安心を求む	に	下に
訓戒を垂れる	に	授業以外に
喧嘩を思う	によって	意見によって
心配を掛ける	て	は	あらわれて	彷徨しているのは
我儘を尽くす	に	町に
訓練を与える	て	は	に	あって	近頃は	大に
鞭撻を加える	は	ば	て	から	て	主人は	おれば	向って	ものであるから	見てとって
平和を告げる	て	乗じて
終了を告げる	を以て	ん	本月を以て	殆ん
一大をする	て	以て
購求を願う	て	て	因って	附して
意味を究める	て	考えて
意味をつける	は	男は
案内を乞う	と	から	で	頼む頼むと	玄関から	声で
案内を頼む	が	迷亭のようだが
修養を力む	から	せんだってから
講釈を聞く	から	人から
立見をする	は	ながら	迷亭君は	笑いながら
邪魔を致す	て	出て
東京をする	で	久し振りで
話を切らす	て	云って
賛成を求める	て	向いて
修養をやる	から	て	感心してしまったから	奮発して
怪我をする	て	飛び降りて
不足をとる	が	は	て	ばかり	貰ったが	中には	あって	二度ばかり
早合点をする	ので	が	と	いいので	こっちが	刑事だと
乱暴を働く	て	使役して
心的を描き出す	に	ありのままに
了見を起す	と	ながら	むらむらと	撫で廻しながら
掃除を始める	は	によって	するのは	例によって
掃除をする	へ	ところへ
失望を受取る	に	上に
催促をしてやる	て	思い切って
同情を起す	て	泣き立てて
化粧を施す	は	て	すん子嬢は	あけて
返事を承る	で	ながら	て	進んで	突きながら	重ねて
宙返りをする	から	が	くらいだから	大分県が
変調を極める	に	吠のように
通りをはじめる	で	畳んで
隠居を引き払う	て	構えて
平均を保つ	やいなや	か	か	伝わるやいなや	どうか	こうか
襲撃を受ける	に	急に
火傷をする	と	注意しないと
絶を執る	に関して	教育に関して
朝食を済ます	て	に	もって	無事に
支度をする	と	御休みよと
欠勤を出す	は	に	へ	主人は	知らずに	学校へ
演説をなする	ば	で	落ちついていれば——	こないだ学校で
話をなさる	が	雪江さんが
仕事を片付ける	と	へ	ところだからと	隅へ
話を仕る	も	坊ばもまた
苦笑をする	と	は	教えてと	妻君は
相談を開く	も	で	——でも	揉んでまた
話を致す	が	私が
近道を通る	のに	から	するのに	正面から
弁論をする	と	は	について	か	雪江さんと	叔母さんは	結婚事件について	何か
同情をする	て	に	満ちて	大に
相談を持ちかける	は	に	雪江さんは	時に
ストライキをしでかす	て	から	なって	云うから
判断をする	と	は	いいだろうと	主人は
尊敬を受ける	も	として	より	人間も	人間として	猫より
いたずらを書く	も	吾輩も
矛盾をする	くらい	と	くらい	公然と
嘆息をする	たり	だり	ひそめたり	かんだり
失礼をする	が	人が
摩擦を与える	は	と	て	に	が	は	破れたのではない	よると	始めて	局部に	穿いているが	これは
会釈をする	に	武右衛門君に
話を聞く	は	僕は
協商を始める	は	細君は
嘆願をする	まで	いつまで
西洋を食う	で	三人で
散歩をする	に	是非いっしょに
運動をする	から	それから
退去を命ずる	に	て	先生に	申して
いたずらを始める	て	は	引きずり出して	独仙君とは
待ったをする	から	さっきから
関係をつける	で	も	と	から	声で	談話にも	えるかいと	方から
兵をする	で	はだしで
奉職をする	が	へ	友人が	あすこへ
勘定をする	て	上げて
計算をする	は	て	で	独仙君は	埋めて	内で
話をつづける	も	は	慰藉されなくても	寒月君は
制裁をする	て	に	云って	むやみに
大息を洩らす	と	は	として	物件だからなあと	主人は	喟然として
是非をする	は	人間は
経験をきく	から	て	に	から	分からないですから	思って	寒月君に	さっきから
説教をする	て	もったい振って
大分をする	から	も	は	ば	次第だから	僕も	はじめるまでには	行かなければ
制裁を加える	ので	云うので
毎日をする	ね	それでね
処分を受ける	て	まかり間違って
祈念をこらす	と	に	に	暮れればいいと	ひそかに	神仏に
下宿を出る	ので	て	入ったので	一息ついて
正面を喰う	と	人迹稀なんですかと
談話をつづける	て	と	は	もって	ふうと	寒月君は
仲間入りをする	て	なってまた
胡坐をかく	で	前で
降参を申し込む	と	は	て	ながら	ついたかいと	主人は	伏せて	起き上りながら
反響を起す	が	声が
震動をはじめる	が	に	両足が	うなりのように
酷評を加える	と	は	が	おどかされるんだと	今度は	主人が
心配をかける	へ	へへへへ
懐中を抜く	に	際に
議論を始める	は	で	主人は	口調で
議論を弄する	て	に	して	舌頭に
探偵を比す	に	スリ泥棒に
自殺を授ける	に	として	て	で	代りに	正科として	なって	中学校で
保護をする	は	と	現代では	目的と
話を進める	と	は	で	恐れ入ると	独仙君は	顔付で
水泳をやる	は	て	と	問題は	這入って	鳴ると
喧嘩を買う	と	で	人間だぞと	中で
下宿を払う	に	も	たり	他人のように	あっても	借りたり
尊敬を払う	て	に	認めて	これに
結婚をする	て	出て
同情を錬る	に	高潔にし
乱暴をかく	から	て	打てないから	なって
算を乱す	が	死骸が
対面をする	と	母と
我慢を重ねる	に	我慢に
行水を使う	で	が	に	所で	吾輩自身が	代りに
